NO ./maps/textures/oak_planks.png
SO ./maps/textures/spruce_planks.png
WE ./maps/textures/stone_bricks.png
EA ./maps/textures/bricks.png

DO ./maps/textures/door.png

F 104,127,81
C 132,178,250
 
        1111111111111111111111111
        1000000000110000000000001
        1011000001110000000111111
        100D000100000000000000001
111111111011000001110000000000001
1000000000D1000000110111111111111
11110111110011011000000010001
1111011111001101110D0100D0001
11000000110D0101110000001000111111111
1000000000000000110000001000000000001
10000S00000000001101010000001111111111
1000000111010101111101D11000111
10111111 11101000000000D0001
1011 111 11111111111111111111
101
101
10111
10001
10001
10001
10001
10001
10001
10001
10001
10001
10001
10001
10001
11111
