NO ./maps/textures/oui.png
SO ./maps/textures/haha.png
WE ./maps/textures/elon_proffesional_looking.png
EA ./maps/textures/china_big.png

DO ./maps/textures/door.png

F 104,127,81
C 132,178,250

        1111111111111111111111111
        1000000000110000000000001
        1011000001110000000111111
        1001000100000000000000001
111111111011000001110000000000001
100000000011000000110111111111111
11110111110011011000000010001
1111D111110011011101010010001
1100000011010101110000001000111111111
1000000000000000DD0000001000000000001
10000S00000000001101010000001111111111
1000000111010101111101111000111
10111111 11101000000000100001
1011 111 11111111111111111101
101                       101
101                       101
10011                     101
10001                     101
10001                     101
10001                     101
10001                     101
10001111111111111111111111101
10000000000000000000000000001
10001111111111111111111111111
10001
10001
10001
10001
10001
11111
