NO ./maps/textures/oak_planks.png
SO ./maps/textures/spruce_planks.png
WE ./maps/textures/stone_bricks.png
EA ./maps/textures/bricks.png

F 104,127,81
C 132,178,250

        1111111111111111111111111
        1000000000110000000000001
        1011000001110000000111111
        1001000000000000000000001
111111111011000001110000000000001
100000000011000000110111111111111
11110111111111011000000010001
11110111111111011101010010001
1100000011010101110000001000111111111
10000000000000001100000010001      01
10000000000000001101010010001111111111
11000001110101011111011110N0111
11111111 1110101 101111010001
1111 111 1111111 111111111111
111
1N1
111
