NO ./maps/textures/oak_planks.png
SO ./maps/textures/spruce_planks.png
WE ./maps/textures/stone_bricks.png
EA ./maps/textures/bricks.png

F 255,0,0
C 000,000,250

11111111111111111111111111111111111111111111111111111111111111111111111111111111111111
10000000000000000000000010000000000000000000000000000000000000000000000000000000000001
10000000111000000000000010000000000000000000000001110000000000000000000000000000000001
10000000001000000000011110000000000000000000000001110000000000000000000000000000000001
10000000001000000010000000000000000000000000000001110000000000000000000000000000000001
10000000001000111110000000000000000000000000000001110000000000000000000000000000000001
1000000000000000000000000000000000000000000000000111000000000000000N000000000000000001
10000000000000000011000000000000000000000000000001110000000000000000000000000000000001
10000000000000000011000000000000000000000000000001111111111111111100000000000000000001
10000000000000000011000000000000000000000000000000000000000000000000000000000000000001
11111111111111111111111111111111111111111111111111111111111111111111111111111111111111
